R 600 400

NO ./textures/brick.xpm
SO ./textures/stone.xpm
WE ./textures/iron.xpm
EA ./textures/wood.xpm

S ./textures/ghost.xpm

F 150,100,0
C 225,30,0


        1111111111111111111111111
        1000000000110000000000001
        1011000001110000002000001
        1001000000000000000000001
111111111011000001110000000000001
100000000000000001110111100111111
11110111111111011100000010001
11110111111111011101010010001
11000000110101011100000010001
10002000000000000000000010001
10000000000000000001010010001
11000001110101011111011110N0111
11110111 1110101 101111010001
11111111 1111111 111111111111
