R 600 400

NO ./textures/brick.xpm
SO ./textures/stone.xpm
WE ./textures/iron.xpm
EA ./textures/wood.xpm

S ./textures/ghost.xpm

F 50,50,50
C 100,200,255

        1111111111111111111111111
        1000000000110000000000001
        1011000001110000002000001
        1001000000000000000000001
111111111011000001110000000000001
100000000011000001110111100111111
11110111111111011100000010001
11110111111111011101010010001
11000000110101011100000010001
10002000000000001100000000N001
10000000000000001101010010001
110000011101010111110111100111
11110111 1110101 101111010001
11111111 1111111 111111111111