R  2000 1500

NO ./textures/kiss.xpm
SO ./textures/thescream.xpm
WE ./textures/thegirl.xpm
EA ./textures/medieval.xpm

S ./textures/baby.xpm

F 102,0,0
C 255,229,204

        1111111111111111111111111
        1000000000110000000000001
        1011000001110000002000001
        1001000000000000000000001
111111111011000001110000000000001
100000000011000001110111100111111
11110111111111011100000010001
11110111111111011101010012221
11000000110101011100020010001
10002000000000001100000000N001
10000000000000001101010010001
110000011101010111110111100111
11110111 1110101 101111012001
11111111 1111111 111111111111