R 600 400

NO ./textures/brick.xpm
SO ./textures/stone.xpm
WE ./textures/iron.xpm
EA ./textures/wood.xpm

S ./textures/ghost.xpm

F 255,20,10
C 100,12,0

11111111
10222201N
12000001
100N0001
10000201
11111111